Techniken	  Wissenscha,lichen	  Arbeitens	  

für	  Poli6kwissenscha,ler	  

1.106	  

WS	  2014/15	  

Dienstag	  14-­‐16	  Uhr	  

06.	  Januar	  2015	  

Fachbereich	  Sozialwissenscha,en	  

	  

	  

TWA	  ‚Produkte‘	  

EIN	  TWA-­‐BEITRAG	  

schri,licher	  Gruppenbeitrag	  
(Umfang	  so	  wie	  Fachbeitrag)	  

a.  Fragestellung	  
b.  Wiss.	  Literatur	  
c.  Eigene	  Ideen	  
d.  1x	  Präsenta6on	  

Fachvortrag	  
TWA	  Plenum	  

Aﬀeld/	  Poppmann	  

Ziel:	  

3	  Produkte	  

pro	  AG	  

03.	  Februar	  2015	  

Abschlusssitzung:	  Poster	  o.	  

krea6ve	  eigene	  Darstellung	  über	  

das	  AG	  Fachthema	  

EIN	  FACHBEITRAG	  

schri,licher	  Gruppenbeitrag	  	  
(5	  -­‐10+	  Seiten	  inkl.	  DeckblaS,	  
Gliederung,	  Lit.liste,	  Anhänge,	  
	  
Schaubilder)	  	  
a.  Fragestellung	  
b.  Wiss.	  Literatur	  
c. 
d.  Eigene	  Ideen	  
e.  2	  x	  Präsenta6onen	  

Interview	  mit	  Experte(n)	  

Probevortrag	  
TWA	  Plenum	  

Aﬀeld/	  Poppmann	  

	  

Premiumvortrag	  

Einf.	  Polwi	  

Musch	  

06.01.15	  

