Autor(en)
/	  Jahr	  

Baumann
&	  Kuhl	  
(2002)	  
S.473	  

Kazén	  &	  
Kuhl	  
(2005)	  
S.	  464-­‐466	  

UV(s)	  
Operationalisiert	  

-­‐LOM	  gemessen	  
durch	  
Persönlichkeits-­‐
fragebögen(?)	  
	  	  	  -­‐Negativer	  
Affekt(NA)	  
-­‐positives	  
Vorbereitungs-­‐
signalwort	  (z.B.	  
Erfolg)	  
-­‐vs.	  Negatives	  
Signalwort	  (z.B.	  
Misserfolg)	  
-­‐vs.	  neutrales	  
Signal	  

	  
Theoretisch	  

-­‐Fähigkeit	  zur	  
nicht	  defensiven	  
Herabregelung	  
negativen	  
AffektsàLOM	  
(quasi-­‐
experimentell)	  
	  -­‐Erschreckene	  
Momente,	  
traurige	  
Filmszenen...	  
-­‐Injizierter	  PA	  
	  	  	  -­‐	  NA	  
	  	  -­‐keine	  

	  

	  
theoretisch	  

-­‐Leistung	  bei	  
Aufgaben,	  die	  eine	  
intuitive	  und	  
parallele	  
Simultanver-­‐
arbeitung	  
mehrerer	  
semantisch	  er	  
Einheiten	  durch	  
ausgedehnte	  
(rechtshemisphäri
sche)	  Netzwerke	  
erfordern	  
-­‐Willensbahnung	  
vs.	  Verhaltens-­‐
bahnung	  

Befund	  

-­‐Leistungs-­‐
beinträchtigung	  bei	  
LOM	  bei	  NA	  bei	  
dieser	  Aufgabe	  

-­‐Die	  Reaktionszeit	  
bei	  Anwesenheit	  
eines	  Vorberei-­‐
tungsreizes,	  der	  
sich	  auf	  positive	  
Erfahrungen	  
beziehen,	  wird	  
kürzer	  

AV(s)	  
operationalisiert	  

-­‐Korrektheit	  der	  
intuitiven	  
Beurteilungen,	  ob	  
drei	  Wörter	  zur	  
Gruppe	  von	  
semantisch	  
irgendwie	  
zusammenhän-­‐
genden	  Wörtern	  
gehören	  oder	  zur	  
Gruppe	  eher	  
unzusammenhän-­‐
gender	  Wörter	  
-­‐Stroop-­‐
Interferenz:	  
Reaktionszeitver-­‐
längerung	  in	  den	  
Durchgängen,	  in	  
denen	  die	  zu	  
benennende	  
Farbe	  nicht	  mit	  
dem	  gezeigten	  	  
Farbwort	  
übereinstimmt	  

Interpretation	  

-­‐LOM	  beeinflusst	  die	  
Leistung	  bei	  Aufgaben,	  
die	  parallele	  
Verarbeitung	  erfordern	  
àGilt	  dieses	  dadurch	  
auch	  für	  übermäßigen	  
NA?	  
-­‐Reduktiion	  oder	  sogar	  
vollständige	  
Beseitigung	  der	  Stroop-­‐
Interferenz,	  wenn	  im	  
Experiment	  jedem	  
Aufgabenreiz	  ein	  
positives	  Wort	  als	  
Vorbereitungssignal	  
vorangestellt	  wird	  
à	  durch	  einen	  
positiven	  
Vorbereitungsreiz	  wird	  
die	  	  nicht	  dominante	  
Reaktion	  gebahnt	  

