Personalmarke1ng	  	  

Methoden	  und	  Beispiele	  

im	  	  Seminar:	  	  

„Ausgewählte	  Themen	  der	  
WirtschaDspsychologie“	  

Im	  WS	  2014/15	  

26.11.14	  

	  

	  

	  

Clemens	  Stoer	  
Ersan	  Akin	  
Sebas1an	  Hansen-­‐Hagge	  
Christopher	  Hunter	  

Inhaltsverzeichnis	  

1.  Personalmarke1ng	  am	  Beispiel	  des	  

Pﬂegedienstes	  im	  Krankenhaus	  

2.  Personalimagewerbung	  am	  Beispiel	  der	  

Commerzbank	  

3.  Vereinbarkeit	  von	  Beruf	  und	  Familie	  –	  

Methoden	  und	  Beispiele	  

	  

2	  

26.11.14	  

1	  

